SO  assets/textures/texture_03.xpm
NO  assets/textures/texture_02.xpm
WE  assets/textures/texture_00.xpm
EA  assets/textures/texture_01.xpm

F   187, 187, 187
C   191, 216, 241

11111111111111111111111111
1000000001000a000100000001
10000000010000000100000001
10000000010000000100000001
1000000001111C111100000001
10000000000000000000000001
10000000000000000000000001
10000000000000000000000001
10000000000000000000000001
1000000000000E000000000001
10000000000000000000000001
11111111111111111111111111